12
1,5,5,5,5,5,5,5,5,5,5,6
1,5,5,5,5,5,5,5,5,5,5,14
1,5,5,5,5,5,5,5,5,5,5,14
1,5,5,5,5,5,5,5,5,5,5,14
1,5,5,5,5,5,5,5,5,5,5,14
1,5,5,5,5,5,5,5,5,5,5,14
1,5,5,5,5,5,5,5,5,5,5,14
1,5,5,5,5,5,5,5,5,5,5,14
1,5,5,5,5,5,5,5,5,5,5,14
1,5,5,5,5,5,5,5,5,5,5,14
1,5,5,5,5,5,5,5,5,5,5,14
1,5,5,5,5,5,5,5,5,5,5,12
