12
1,5,5,5,5,5,5,5,5,5,5,6
3,5,5,5,5,5,5,5,5,5,5,14
11,5,5,5,5,5,5,5,5,5,5,14
11,5,5,5,5,5,5,5,5,5,5,14
9,5,5,5,5,5,5,5,5,5,5,14
3,5,5,5,5,5,5,5,5,5,5,14
9,5,5,5,5,5,5,5,5,5,5,14
3,5,5,5,5,5,5,5,5,5,5,14
11,5,5,5,5,5,5,5,5,5,5,14
11,5,5,5,5,5,5,5,5,5,5,14
11,5,5,5,5,5,5,5,5,5,5,14
9,5,5,5,5,5,5,5,5,5,5,12
